#################################
#       #                       #
#       #        #############  #
#   X       O   ##...........#  #
#       #        #...........#  #
#       #        #...........#  #
##################...........#  #
.............................#  #
##############################  #
#                               #
#                               #
#                               #
#          O    O               #
#                               #
#                               #
#                               #
#################################