........#########################
..#####.#                       #
..#   ###        #############  #
..# X       O    #...........#  #
..#   ###        #...........#  #
..#####.#        #...........#  #
........##########...........#  #
.............................#  #
.............................#  #
.............................#  #
.............................#  #
##############################  #
#                               #
#                               #
#                               #
#          O    O               #
#                               #
#          *                    #
#                               #
#################################